@@@@@
@   @@
@  x+@
@@x .@
 @  .@
 @@@@@