 @@@@@
@@+..@
@ xx@@
@    @
@@   @
 @@@@@