@@@@@@@
@+.@  @
@  x  @
@@ @@ @@
 @ @@  @
 @. x  @
 @  @  @
 @@@@@@@