  @@@@@
 @@+  @
@@ x@ @
@.  x.@
@@@@@@@