@@@@@
@  .@
@+xx@@
@@  .@
 @@@@@