 @@@@@
@@  .@
@ xx @
@ +.@@
@@@@@