  @@@@@
@@@.x.@
@  x+ @
@   @@@
@@@@@