  @@@@@
  @   @
  @ @ @
@@@x  @
@+x.. @
@@@.x @
  @@@@@