@@@@@@
@   .@
@ xx+@
@  @.@
@@@@@@