 @@@@@
@@   @
@ .x @
@+@@.@
@ x.x@
@@ @ @
 @   @
 @@@@@