@@@@@
@.x @
@.x @
@.x @
@.x @
@ + @
@@@@@