@@@@@
@ . @@
@    @
@ .x @
@@@x @
  @ +@
  @@@@